null Connection timed outnull Connection timed outnull Connection refused5	.977 The Hitz Channel	 connected false	[port]
6	Secklow Sounds	 connected true	[port]
7	181.FM - POWER 181	 connected false	[port]
8	POWER HITZ	 connected false	[port]
9	THE HITLIST 	 connected false	[port]
10	Energia 97.9 FM Medellin	 connected true	[port]
null Connection refusednull Connection refused13	XEK 960 AM	 connected true	[port]
14	La Estacion Grande de Nuevo Laredo	 connected true	[port]
null Connection refused17	Salamanca Radio	 connected true	[port]
null Connection refusednull Invalid Http responsenull Invalid Http responsenull Connection timed outnull Connection refusednull Connection timed out24	Death.FM	 connected true	[port]
null Connection timed out27	RADIO SOUND POP 2	 connected true	[port]
null connect timed outnull Connection timed outnull Connection refusednull Connection timed outnull Connection refusednull Connection refused36	Ke Buena 93.7 FM	 connected true	[port]
37	Radio XY	 connected true	[port]
null connect timed outnull Invalid Http responsenull Connection refused42	RMX Guadalajara	 connected true	[port]
43	RMX Queretato	 connected true	[port]
44	RMX Laredo	 connected true	[port]
45	Radio RMX Latin	 connected true	[port]
46	Los 40 Principales 88.1	 connected false	[port]
null Connection timed outnull Connection refused49	Russian Radio	 connected true	[url]
50	Zona 3 91.5 fm	 connected false	[port]
null Connection timed outnull Connection refusednull scfire-mtc-aa06.stream.aol.com54	iLove Radio 1	 connected true	[url]
55	iLove Radio 2	 connected true	[url]
null Connection refused57	Radio Playa	 connected true	[url]
58	Rock 101	 connected true	[port]
64	Crossfader	 connected true	[port]
65	Music Machine	 connected true	[port]
68	ROCKRADIO.COM	 connected true	[port]
null Connection refusednull Connection refusednull Invalid Http response72	EBM-Radio 2	 connected true	[port]
73	Nacion Alternativa	 connected true	[port]
null Connection timed outnull Connection refusednull Connection timed out77	ALTERNATIVA FM 3	 connected true	[port]
null Connection timed out79	Radio alternativa 2	 connected true	[port]
null Connection refusednull Connection timed out82	104 FM + Alternativa	 connected true	[port]
null Connection refusednull Connection timed outnull Connection timed outnull Connection refusednull Connection timed outnull Connection refused91	Rdio Alternativa FM Januria	 connected true	[port]
null Connection refusednull Connection refused94	Alternativa Web Radio	 connected true	[port]
null Connection timed out97	Radio Alternativa FM 2	 connected false	[port]
98	Radio Alternativa Mix	 connected true	[port]
99	NOVA ALTERNATIVA FM 87.9	 connected false	[port]
null Connection refusednull Connection timed out102	HDRN - Hard Drivin Radio 2	 connected false	[port]
103	Longside Radio	 connected true	[port]
104	La Kalle 96.3 FM	 connected true	[port]
105	Swiss Internet Radio	 connected true	[port]
null Connection timed out107	SKY.FM	 connected true	[port]
108	SnakeNet Metal Radio	 connected true	[port]
null Connection timed outnull Connection timed out133	Celestia Radio	 connected false	[port]
null Connection refusednull Connection refusednull Invalid Http response152	181.FM The Buzz	 connected false	[port]
null Invalid Http responsenull Connection timed out155	Audio Ink Radio	 connected true	[port]
null Connection timed out199	FUTURA FM	 connected true	[port]
204	FUTURA FM 1	 connected true	[port]
205	181.fm - The Mix Channel	 connected true	[port]
206	181.fm - The Mix Channel 2	 connected true	[port]
207	181.fm - The Mix Channel 3	 connected true	[port]
211	181.fm - The Mix Channel 4	 connected true	[port]
212	181.fm - The Eagle	 connected true	[port]
214	181.fm - The Eagle 1	 connected true	[port]
null scfire-mtc-aa03.stream.aol.comnull scfire-ntc-aa03.stream.aol.comnull http://scfire-ntc-aa02.stream.aol.com:80/stream/1004null connect timed outnull Connection refused222	Public Domain Classical	 connected true	[port]
223	Public Domain Classical 1	 connected true	[port]
null Connection refused225	Classical Piano Trios	 connected true	[port]
228	RADIO FORMULA MORELIA	 connected true	[port]
null scfire-dtc-aa03.stream.aol.comnull scfire-ntc-aa03.stream.aol.comnull scfire-mtc-aa02.stream.aol.comnull scfire-mtc-aa03.stream.aol.comnull scfire-mtc-aa01.stream.aol.comnull Invalid Http responsenull scfire-ntc-aa04.stream.aol.com236	Pinguin Radio	 connected true	[port]
238	Pinguin Radio 1	 connected true	[port]
240	Pinguin Radio 2	 connected true	[port]
241	FM4	 connected true	[port]
null Connection timed outnull scfire-mtc-aa02.stream.aol.comnull scfire-mtc-aa03.stream.aol.comnull scfire-ntc-aa04.stream.aol.comnull scfire-dtc-aa03.stream.aol.com247	KCRW ECLECTIC24 4	 connected true	[port]
248	181.FM - 90s Alternative	 connected true	[port]
252	Maxima 106.7 FM	 connected true	[port]
253	980s.FM	 connected true	[port]
254	181.FM - Smooth AC	 connected true	[port]
257	181.FM - Smooth AC 1	 connected true	[port]
258	100Hitz 	 connected true	[port]
261	181.fm - Chloe	 connected true	[port]
262	181.fm - Chloe 1	 connected true	[port]
264	181.fm - Chloe 2	 connected true	[port]
265	KOZT - The Coast	 connected true	[port]
267	Hit Music Radio	 connected true	[port]
null Connection reset271	SUBASIO PIU	 connected true	[port]
272	Today Mix 106 Hot AC Hits	 connected true	[port]
null Connection timed outnull Connection refused275	KKJL San Luis Obispo	 connected true	[port]
277	HOME.fm	 connected true	[port]
null Connection timed outnull Invalid Http response282	Are Radio 96	 connected true	[port]
286	U7RADIO	 connected true	[port]
null Invalid Http response288	idobi 2	 connected true	[port]
289	idobi 3	 connected true	[port]
290	idobi 4	 connected true	[port]
291	idobi 5	 connected true	[port]
292	idobi 6	 connected true	[port]
293	idobi 7	 connected true	[port]
294	idobi 8	 connected true	[port]
295	Tinimy.de	 connected true	[port]
null Connection timed outnull Connection timed outnull scfire-ntc-aa06.stream.aol.comnull Connection timed out301	COPE DON BENITO VVA 	 connected true	[port]
null Connection timed outnull Connection timed out305	Mexico FM 1	 connected true	[port]
307	Mexico FM 2	 connected true	[port]
308	RTV MEXICO 	 connected true	[port]
null Connection timed outnull Connection timed outnull Connection timed outnull Connection timed out315	dallas korean radio	 connected true	[port]
317	KABC Korean Broadcasting	 connected true	[port]
null Connection refused320	Mxproject.com radio	 connected true	[port]
321	todoexitos metal	 connected true	[port]
null Connection timed outnull Connection timed out326	LA HUASTECA 	 connected false	[port]
327	Radio Conciencia	 connected false	[port]
328	Radio Al otro lado del espejo	 connected true	[port]
null Connection timed outnull Connection refusednull Connection timed outnull Connection timed outnull Connection timed outnull Invalid Http responsenull Connection timed outnull Connection timed outnull Connection timed outnull Connection timed outnull Connection timed outnull Connection timed outnull Connection timed outnull Connection timed outnull Connection timed outnull Connection timed outnull Connection timed outnull Connection timed outnull Connection timed outnull Connection timed outnull Connection timed outnull Connection timed outnull Connection refused352	Bachata Radio	 connected true	[port]
null Connection timed outnull Connection timed outnull Connection timed outnull Connection timed out359	RockRadio1.Com	 connected true	[port]
null Connection timed out361	RockRadio1.Com 2	 connected true	[port]
362	RockRadio1.Com 3	 connected true	[port]
null Connection refusednull Connection refusednull Connection timed out366	METAL ONLY	 connected true	[port]
null Connection timed outnull scfire-dtc-aa03.stream.aol.com371	ChroniX Aggression Radio 1	 connected false	[port]
374	ChroniX Aggression Radio 2	 connected true	[port]
null Connection timed outnull Connection refusednull Connection refusednull Connection refusednull Connection refused382	Hard Rock Radio Live 5	 connected false	[port]
383	Hard Rock Radio Live 6	 connected false	[port]
null Connection timed outnull Connection refusednull connect timed out388	Kpop Radio	 connected true	[port]
null connect timed outnull Connection refusednull Connection timed out394	kpop radio pdm	 connected true	[port]
396	XAMFM	 connected true	[port]
null Connection refused398	XAMFM 2	 connected true	[port]
null Connection refusednull Connection timed outnull Connection refused403	Big B Radio 3	 connected true	[port]
null Connection refusednull Connection refused407	Top Grupero	 connected true	[port]
408	Entorno Grupero	 connected true	[port]
null Connection refused411	Rockeros.net Radio 	 connected true	[port]
null Connection refused413	La Grosse Radio Reggae	 connected true	[port]
414	La Grosse Radio Reggae 1	 connected true	[port]
415	La Grosse Radio Reggae 2	 connected true	[port]
null Invalid Http responsenull scfire-dtc-aa03.stream.aol.comnull scfire-ntc-aa04.stream.aol.com422	Roots Reggae 3	 connected true	[port]
423	BOOMSTATION.NET BLAZING REGGAE	 connected true	[port]
null Connection timed out425	BigUpRadio Champion Sound 1	 connected true	[port]
null Connection timed outnull Invalid Http responsenull Connection timed out432	Fiesta Latina	 connected true	[port]
433	ElBachaRengue.Ne	 connected true	[port]
null Connection timed out435	TROPICALISIMA.FM	 connected true	[port]
null Connection timed outnull Connection refused439	Piano Improvisation	 connected false	[port]
440	Piano Disc	 connected true	[port]
null Connection timed out443	Pinetree	 connected false	[port]
null Server returned HTTP response code: 401 for URL: http://live.str3am.com:3120/secure448	Interferencia 710	 connected true	[port]
null Connection refused452	Blast 106	 connected true	[port]
null Invalid Http response454	91.5 Kingdom FM	 connected true	[port]
455	AudiobookRadio	 connected false	[url]
456	Jazz Groove: Radio Rewers	 connected true	[port]
null Connection refusednull Invalid Http response460	AmbienT CorBinA RaDiO StatioN	 connected false	[port]
461	AmbienT CorBinA RaDiO StatioN 1	 connected false	[port]
null Connection timed out463	1.FM - CHILLOUT LOUNGE RADIO	 connected true	[port]
null Connection refused465	CINEMIX	 connected true	[port]
466	CINEMIX 1	 connected true	[port]
null Connection timed outnull Connection refusednull Connection refusednull Connection timed outnull Connection timed outnull connect timed out474	WRadio	 connected true	[port]
475	Radio lorelay 	 connected true	[port]
null Connection timed outnull Connection refused480	COOL93 fahrenheit 1	 connected false	[port]
481	COOL93 fahrenheit 2	 connected true	[port]
482	COOL93 fahrenheit 3	 connected true	[port]
483	FIESTA MEXICANA	 connected true	[port]
null Invalid Http responsenull Connection refused488	Los 40 Principales Tampico	 connected true	[port]
489	Los 40 Principales 	 connected true	[port]
null Connection refused493	Los 40 Principales 1	 connected true	[port]
494	Los 40 Principales Ecuador	 connected true	[port]
495	Los 40 Principales Irapuato	 connected true	[port]
496	Los 40 principales Acapulco	 connected true	[port]
497	Los 40 principales 89.9 FM	 connected true	[port]
498	Los 40 Principales Poza Rica	 connected true	[port]
null Connection refused501	Los 40 Principales Isla del Carmen	 connected true	[port]
502	Los 40 Principales 2	 connected false	[port]
503	Los 40 Principales  Republica Dominicana	 connected true	[port]
null Connection timed out505	Los 40 Principales  Republica Dominicana 3	 connected true	[port]
506	CANDELA MORELIA 92.3 	 connected true	[port]
507	Radio Mexico Para Cristo	 connected true	[port]
508	Panda Show	 connected true	[port]
509	Panda Show 1	 connected true	[port]
null Connection timed outnull Connection timed out513	Panda Show 2	 connected true	[port]
null Connection timed outnull Connection timed out517	MARIACHI DIGITAL	 connected false	[url]
519	Radio Voix Ave Maria	 connected true	[port]
520	Radio Maria Indonesia	 connected true	[port]
inactives 181 actives 164